pww0000wwp
w00000000w
w00000000w
0000000000
0000000000
0000000000
0000000000
w00000000w
w00000000w
pww0000wwp