wwww00000w
000000000w
000000p00w
00p000000w
0000000000
0000000000
w000000p00
w00p000000
w000000000
w00000wwww
