pp00ww00pp
p00w00w00p
0000000000
0w000000w0
w00000000w
w00000000w
0w000000w0
0000000000
p00w00w00p
pp00ww00pp